{
  "project_key": "BHEEM",
  "epics": {
    "BEEM-3": [
      "FR-001",
      "FR-002",
      "FR-003",
      "FR-004",
      "FR-005",
      "FR-006"
    ],
    "BHEEM-4": [
      "FR-007",
      "FR-008",
      "FR-009",
      "FR-010",
      "FR-011",
      "FR-012",
      "FR-013",
      "FR-014",
      "FR-015",
      "FR-016",
      "FR-017",
      "FR-018",
      "FR-019",
      "FR-020",
      "NFR-004",
      "NFR-006"
    ],
    "BHEEM-5": [
      "FR-021",
      "FR-022",
      "FR-023",
      "FR-024",
      "FR-025",
      "FR-026"
    ],
    "BHEEM-6": [
      "FR-027",
      "FR-028",
      "FR-029",
      "FR-030",
      "FR-031",
      "FR-032",
      "FR-033",
      "FR-034",
      "NFR-001",
      "NFR-003",
      "NFR-009"
    ],
    "BHEEM-7": [
      "FR-035",
      "FR-036",
      "FR-037",
      "FR-038",
      "FR-039",
      "FR-040",
      "FR-041",
      "FR-042",
      "NFR-002",
      "NFR-005",
      "NFR-012"
    ],
    "BHEEM-8": [
      "FR-043",
      "FR-044",
      "FR-045",
      "FR-046",
      "FR-047",
      "FR-048",
      "NFR-014"
    ],
    "BHEEM-9": [
      "FR-049",
      "FR-050",
      "FR-051",
      "FR-052",
      "FR-053",
      "FR-054",
      "FR-055",
      "NFR-007",
      "NFR-008",
      "NFR-010",
      "NFR-013"
    ],
    "BHEEM-10": [
      "FR-056",
      "FR-057",
      "FR-058",
      "FR-059",
      "FR-060",
      "NFR-011",
      "NFR-015",
      "NFR-016"
    ]
  }
}
